10 20 #
##################### ###################
#             #   #           #     #   #
# ##### ##### # # ##### ### ### # ### # #
#     # #   #   #   #   #   #   #     # #
### ### # # ####### # ### ### ######### #
#   #   # # #       # # #   #   #     # #
# ### ### # # ####### # ### ### # ### # #
# #   #   #         # #   #   # # #   # #
# # ############### # # # ### # ### # # #
# #     #       #     # #   # #     # # #
# ##### # ##### # ##### ### # ####### # #
# #   #       # # #   # # #   # #   # # #
# # # ######### # # # # # ##### # # # ###
# # #   #   #   # # # #         # #   # #
# # ### # # # ##### # ####### ### ##### #
# #   # # #   #     #   #     #   #     #
# ### # # # ### ####### ### ### ### # # #
# #   # # # #   #     #   # #   #   # # #
# # ### # ### ### ### ### ### ####### # #
#   #   #         #     #             # #
##################### ###################
